lemmingspeed	300
gamespeed	2
time	150
number	2
tosave	4
climber	10
paratrooper	10
blocker	10
bomber	10
builder	10
digger	10
miner	10
map
-------------------------------
-0          +                @-
-           ---------------+---
-          ----------------  --
-+       ------------------+--
-+   ++++  ++---------------+--
-+  ------------------------+--
----------------------------  -
-------------------------------
###############################
###############################